UPGRADE GUIDE

Breath weapon: special area attack, press b during battle to activate.
Classes: raises hit dice, base attack bonus and saving throws.
Damage reduction: reduces damage from physical attacks.
Darkvision: greatly improved vision when dark.
Energy resistance/immunity: reduces or ignores damage from non-physical attacks.
Fast healing: heal a certain number of hit points per turn (1AP).
Flying: allows character to fly over terrain and water.
Great fortitude: +2 fortitude.
Improved initiative: +4 initiative.
Improved precise shot: ignores the -4 penalty for cover (requires Precise shot, dexterity 19, BAB +11).
Iron will: +2 will.
Lightning reflexes: +2 reflexes.
Low-light vision: improved vision when dark.
Mêlée damage: raises damage of all mêlée attacks.
Mêlée focus: +1 to all mêlee attack bonuses (requires +1 Base Attack Bonus).
Natural armor: raises armor class.
Point blank shot: you get a +1 bonus on attack and damage rolls with ranged weapons at ranges of up to 30 feet.
Precise shot: ranged attacks ignore the -4 penalty for engaged targets (requires Point blank shot).   
Raise constitution: raises fortitude, hit points and breath weapon saving throw difficulty.
Raise dexterity: raises armor class, reflexes, ranged attack bonuses and initiative.
Raise strength: raises mêlée attack bonuses and damage.
Raise wisdom: raises will saving throw bonus.
Ranged damage: raises damage of all ranged attacks.
Ranged focus: +1 to all ranged attack bonuses (requires +1 Base Attack Bonus).
Rapid shot: you can make an extra ranged attack but have a -2 penalty to all attacks for a turn (requires Precise shot, dexterity 13).
Spell resistance: the more powerful your resistance, the less likely you'll be affected by harmful spells.
Spell immunity:  cannot be the target of harmful spells.
Swimming: swims over water faster, ignores penalties for being on water. 
Toughness: +3 hit points.